Deep in the heart of the Lonely Mountain there was a tomb. Not a nasty, dirty wet tomb, filled with ooze and the ends of worms, nor yet a sterile, gloomy tomb with nothing to look at or admire; it was a dwarven tomb, and that means magnificence.

The Arkenstone
An Interactive Fiction by Milo Kim
Release 1 / Serial number 190114 / Inform 7 build 6M62 (I6/v6.33 lib 6/12N) SD

Great Chamber of Thror
High above, a small opening of some sort provides a glimmer of light and a faint breeze from outside. The walls of the great chamber are out of the light's reach, though. A few overturned tables and a broken lantern are all that can be seen.

You can see a lantern here.

>d
You can't go that way.

>d
You can't go that way.

>n
Thorin's Tomb
Deep in the heart of the Lonely Mountain there was a tomb. Not a nasty, dirty wet tomb, filled with ooze and the ends of worms, nor yet a sterile, gloomy tomb with nothing to look at or admire; it was a dwarven tomb, and that means magnificence.

>in
Mausoleum
It was a gleaming stone mausoleum carved with silver-flecked granite statues of noble dwarves, surrounded by sturdy yet elegant benches, playful fountains and pools catching the light from gem-like windows high overhead; all emanating a sense of peace and welcome.

You can see a scroll here.

>x scroll
 A rolled-up scroll.

>x scroll
An unrolled scroll with a mysterious inscription.

* * *

>d
You can't go that way.

>take lantern
A young dwarf carrying a set of mason's tools hurries into the room, happens upon the broken lantern, and lights it. After looking around in wonder and respect at the newly-lit surroundings, he takes it back to the entrance he came from, and calls for his fellow workers to join him. You can now see the Great Hall in full.

Great Hall of Thror
This enormous chamber is filled with activity as dozens of dwarves work to restore it to its former glory. Dust and cobwebs are being cleared away, the conference tables repaired, hearths rekindled, and broken carvings either smoothed and plished again or replaced with new ones. Dwarves on high ladders are even re-opening the skylights, allowing more fresh air and sunlight to fill the room. In the new light, you see a pair of majestic doors leading east towards the sound of rushing water, as well as an archway with stairs leading deep down towards the heart of the Lonely Mountain.

* * *

>d
You can't go that way.

>look
Great Hall of Thror
High above, a small opening of some sort provides a glimmer of light and a faint breeze from outside. The walls of the great chamber are out of the light's reach, though. A few overturned tables and a broken lantern are all that can be seen.

You can see a lantern here.

>take lantern
A young dwarf carrying a set of mason's tools hurries into the room, happens upon the broken lantern, and lights it. After looking around in wonder and respect at the newly-lit surroundings, he takes it back to the entrance he came from, and calls for his fellow workers to join him. You can now see the Great Hall in full.

Great Hall of Thror
This enormous chamber is filled with activity as dozens of dwarves work to restore it to its former glory. Dust and cobwebs are being cleared away, the conference tables repaired, hearths rekindled, and broken carvings either smoothed and plished again or replaced with new ones. Dwarves on high ladders are even re-opening the skylights, allowing more fresh air and sunlight to fill the room. In the new light, you see a pair of majestic doors leading east towards the sound of rushing water, as well as an archway with stairs leading deep down towards the heart of the Lonely Mountain.

* * *

>n
You can't go that way.

* * *

>d
Winding Stairs

>d
Long Hallway

>n
Thorin's Tomb
Deep in the heart of the Lonely Mountain there was a tomb. Not a nasty, dirty wet tomb, filled with ooze and the ends of worms, nor yet a sterile, gloomy tomb with nothing to look at or admire; it was a dwarven tomb, and that means magnificence.

* * *

>x scroll
An unrolled scroll with a mysterious inscription.

>take scroll
Taken.

* * *

>d
Winding Stairs

>look
Great Hall of Thror
This enormous chamber is filled with activity as dozens of dwarves work to restore it to its former glory. Dust and cobwebs are being cleared away, the conference tables repaired, hearths rekindled, and broken carvings either smoothed and plished again or replaced with new ones. Dwarves on high ladders are even re-opening the skylights, allowing more fresh air and sunlight to fill the room. In the new light, you see a pair of majestic doors leading east towards the sound of rushing water, as well as an archway with stairs leading deep down towards the heart of the Lonely Mountain.

* * *

>go down
Winding Stairs

>go up
Great Hall of Thror
High above, a small opening of some sort provides a glimmer of light and a faint breeze from outside. The walls of the great chamber are out of the light's reach, though. A few overturned tables and a broken lantern are all that can be seen.

You can see a lantern here.

>move down
You must name something more substantial.

>travel down
That's not a verb I recognise.

>s
You can't go that way.

* * *

>look
Thorin's Tomb

It was a gleaming stone mausoleum carved with silver-flecked granite statues of noble dwarves, surrounded by sturdy yet elegant benches, playful fountains and pools catching the light from gem-like windows high overhead; all emanating a sense of peace and welcome.

* * *

>n
You can't go that way.

* * *

>take lantern
A young dwarf carrying a set of mason's tools hurries into the room, happens upon the broken lantern, and lights it. After looking around in wonder and respect at the newly-lit surroundings, he takes it back to the entrance he came from, and calls for his fellow workers to join him. You can now see the Great Hall in full.

Great Hall of Thror
This enormous chamber is filled with activity as dozens of dwarves work to restore it to its former glory. Dust and cobwebs are being cleared away, the conference tables repaired, hearths rekindled, and broken carvings either smoothed and plished again or replaced with new ones. Dwarves on high ladders are even re-opening the skylights, allowing more fresh air and sunlight to fill the room. In the new light, you see a pair of majestic doors leading east towards the sound of rushing water, as well as an archway with stairs leading deep down towards the heart of the Lonely Mountain.

* * *

>n
You can't go that way.

>s
You can't go that way.

>e
You can't go that way.

>u
You can't go that way.

>examine
(the lantern)
You see nothing special about the lantern.

>take lantern
A young dwarf carrying a set of mason's tools hurries into the room, happens upon the broken lantern, and lights it. After looking around in wonder and respect at the newly-lit surroundings, he takes it back to the entrance he came from, and calls for his fellow workers to join him. You can now see the Great Hall in full.

Great Chamber of Thror
This enormous chamber is filled with activity as dozens of dwarves work to restore it to its former glory. Dust and cobwebs are being cleared away, the conference tables repaired, hearths rekindled, and broken carvings either smoothed and polished again or replaced with new ones. Dwarves on high ladders are even re-opening the skylights, allowing more fresh air and sunlight to fill the room. In the new light, you see a pair of majestic doors leading east towards the sound of rushing water, as well as an archway with stairs leading deep down towards the heart of the Lonely Mountain, as well as another pair of gilded doors to the south.

* * *

>s
You can't go that way.

>n
You can't go that way.

>e
You can't go that way.

>w
You can't go that way.

>take lantern
A young dwarf carrying a set of mason's tools hurries into the room, happens upon the broken lantern, and lights it. After looking around in wonder and respect at the newly-lit surroundings, he takes it back to the entrance he came from, and calls for his fellow workers to join him. You can now see the Great Hall in full.

Great Hall of Thror
This enormous chamber is filled with activity as dozens of dwarves work to restore it to its former glory. Dust and cobwebs are being cleared away, the conference tables repaired, hearths rekindled, and broken carvings either smoothed and plished again or replaced with new ones. Dwarves on high ladders are even re-opening the skylights, allowing more fresh air and sunlight to fill the room. In the new light, you see a pair of majestic doors leading east towards the sound of rushing water, as well as an archway with stairs leading deep down towards the heart of the Lonely Mountain.

* * *

>take lantern
A young dwarf carrying a set of mason's tools hurries into the room, happens upon the broken lantern, and lights it. After looking around in wonder and respect at the newly-lit surroundings, he takes it back to the entrance he came from, and calls for his fellow workers to join him. You can now see the Great Hall in full.

Great Chamber of Thror
This enormous chamber is filled with activity as dozens of dwarves work to restore it to its former glory. Dust and cobwebs are being cleared away, the conference tables repaired, hearths rekindled, and broken carvings either smoothed and polished again or replaced with new ones. Dwarves on high ladders are even re-opening the skylights, allowing more fresh air and sunlight to fill the room. In the new light, you see a pair of majestic doors leading east towards the sound of rushing water, as well as an archway with stairs leading deep down towards the heart of the Lonely Mountain, as well as another pair of gilded doors to the south.

>d
Winding Stairs
The stairs are very steep and wind down around a central pillar for what seems like an eternity. Stairwells and doorways often appear on the landings, but they are all blocked by old rubble or barricades. Eventually the final stairwell appears. Great dwaven statues loom over several doorways, all of them open, but only the one to the north has been unblocked.

>d
Long Hallway

>n
Thorin's Tomb
Deep in the heart of the Lonely Mountain there was a tomb. Not a nasty, dirty wet tomb, filled with ooze and the ends of worms, nor yet a sterile, gloomy tomb with nothing to look at or admire; it was a dwarven tomb, and that means magnificence.

It was a gleaming stone mausoleum carved with silver-flecked granite statues of noble dwarves, surrounded by sturdy yet elegant benches, playful fountains and pools catching the light from gem-like windows high overhead; all emanating a sense of peace and welcome.

>in
You can't go that way.

>enter
You must supply a noun.

>enter Mausoleum
That's not something you can enter.

>inside
You can't go that way.

* * *

>d
Winding Stairs
The stairs are very steep and wind down around a central pillar for what seems like an eternity. Stairwells and doorways often appear on the landings, but they are all blocked by old rubble or barricades. Eventually the final stairwell appears. Great dwaven statues loom over several doorways, all of them open, but only the one to the north has been unblocked.

>n
Long Hallway
This hallway is brightly lit, causing the gilded carvings on either side to glimmer magnificently. They are seperated into 4 different scenes, including one on the south end that seem unfinished. The south end goes through a doorway and turns into stairs leading up. The north end opens onto a wide cavern.

>n
Thorin's Tomb
Crystals festoon the walls of this wide, natural cave, and a small river runs through the middle. However, what truly dominates the cave is the magnificent dwarven mausoleum next to the river.

>i
You are carrying nothing.

>in
Mausoleum
A gleaming stone mausoleum carved with silver-flecked granite statues of noble dwarves, surrounded by sturdy yet elegant benches, playful fountains and pools catching the light from gem-like windows high overhead; all emanating a sense of peace and welcome.

You can see a mourners and a scroll here.

* * *

>n
Thorin's Tomb
Crystals festoon the walls of this wide, natural cave, and a small river runs through the middle. However, what truly dominates the cave is the magnificent dwarven mausoleum next to the river.

>in
Mausoleum
A gleaming stone mausoleum carved with silver-flecked granite statues of noble dwarves, surrounded by sturdy yet elegant benches, playful fountains and pools catching the light from gem-like windows high overhead; all emanating a sense of peace and welcome.

A gathering of high-ranking dwarves from various clans, here to pay respects to the recently departed.

You can also see a scroll here.

* * *

>d
Winding Stairs
The stairs are very steep and wind down around a central pillar for what seems like an eternity. Stairwells and doorways often appear on the landings, but they are all blocked by old rubble or barricades. Eventually the final stairwell appears. Great dwaven statues loom over several doorways, all of them open, but only the one to the north has been unblocked.

>s
You can't go that way.

>d
Long Hallway

>d
You can't go that way.

* * *

>n
Thorin's Tomb
Deep in the heart of the Lonely Mountain there was a tomb. Not a nasty, dirty wet tomb, filled with ooze and the ends of worms, nor yet a sterile, gloomy tomb with nothing to look at or admire; it was a dwarven tomb, and that means magnificence.

>s
Long Hallway

>s
You can't go that way.

>w
You can't go that way.

>e
You can't go that way.

>s
You can't go that way.

>d
You can't go that way.

>up
Winding Stairs

>up
Great Hall of Thror
This enormous chamber is filled with activity as dozens of dwarves work to restore it to its former glory. Dust and cobwebs are being cleared away, the conference tables repaired, hearths rekindled, and broken carvings either smoothed and polished again or replaced with new ones. Dwarves on high ladders are even re-opening the skylights, allowing more fresh air and sunlight to fill the room. In the new light, you see a pair of majestic doors leading east towards the sound of rushing water, as well as an archway with stairs leading deep down towards the heart of the Lonely Mountain.

>s
You can't go that way.

* * *

>look
Great Hall of Thror
This enormous chamber is filled with activity as dozens of dwarves work to restore it to its former glory. Dust and cobwebs are being cleared away, the conference tables repaired, hearths rekindled, and broken carvings either smoothed and plished again or replaced with new ones. Dwarves on high ladders are even re-opening the skylights, allowing more fresh air and sunlight to fill the room. In the new light, you see a pair of majestic doors leading east towards the sound of rushing water, as well as an archway with stairs leading deep down towards the heart of the Lonely Mountain.

You can see a lantern here.

* * *

>take lantern
You can't see any such thing.

>look
Great Hall of Thror
This enormous chamber is filled with activity as dozens of dwarves work to restore it to its former glory. Dust and cobwebs are being cleared away, the conference tables repaired, hearths rekindled, and broken carvings either smoothed and plished again or replaced with new ones. Dwarves on high ladders are even re-opening the skylights, allowing more fresh air and sunlight to fill the room. In the new light, you see a pair of majestic doors leading east towards the sound of rushing water, as well as an archway with stairs leading deep down towards the heart of the Lonely Mountain.

>d
Winding Stairs

* * *

>in
You can't go that way.

>exits
That's not a verb I recognise.

* * *

>x lantern
The lantern is covered in dust, like everything else in the room, but seems oddly new. Perhaps a wayward adventurer dropped it here in recent years, and forgot to pick it up. The glass is broken, but it is still usable.